bp|bp|snippets
Ip|IpSendMsg|buffer
fd|fd|snippets
Ip|Ipv4Addr|rust-analyzer
HashS|HashSet|rust-analyzer
Forwa|ForwardingTable|rust-analyzer
InterfaceId|InterfaceId|rust-analyzer
I|Ipv4Addr|rust-analyzer
InterfaceI|InterfaceId|rust-analyzer
Inter|InterfaceId|rust-analyzer
chann|channel|rust-analyzer
Time|RecvTimeoutError|rust-analyzer
Time|RecvTimeoutError::Timeout|rust-analyzer
Rec|RecvTimeoutError::Timeout|rust-analyzer
Durn|Duration|rust-analyzer
tod|todo!|rust-analyzer
ed|edebug!|rust-analyzer
de|debug!|rust-analyzer
me|mesh|file
re|release|file
l|len|rust-analyzer
ne|neighbors|rust-analyzer
f|fd|snippets
debg|debug!|rust-analyzer
creat|create_dir_all|rust-analyzer
Path|Path|rust-analyzer
dot|dot|rust-analyzer
dist|dist|rust-analyzer
i|if|rust-analyzer
|v_id|rust-analyzer
deb|debug!|rust-analyzer
cfg|cfg|snippets
debug|debug!|rust-analyzer
debu|debug!|rust-analyzer
BTreeM|BTreeMap|rust-analyzer
Order|OrderedFloat|rust-analyzer
Ax|Axis {â€¦}|rust-analyzer
gener|general_mat_mul|rust-analyzer
Array|Array|rust-analyzer
Cou|Counter|rust-analyzer
|into_iter|rust-analyzer
Has|HashMap|rust-analyzer
BTreeSe|BTreeSet|rust-analyzer
BTree|BTreeSet|rust-analyzer
Ver|Vertex|rust-analyzer
d|d|snippets
de!|debug!|rust-analyzer
old_face|old_faces|rust-analyzer
V|VertexId|rust-analyzer
Inter|Intersection|rust-analyzer
assert_e|assert_eq!|rust-analyzer
fpd|fpd|snippets
tot|total_length|rust-analyzer
pro|protocol|rust-analyzer
dest|destination_address|rust-analyzer
sour|source_address|buffer
P|Protocol|rust-analyzer
Pro|Protocol::Test|rust-analyzer
from|from_utf8|rust-analyzer
get_data|get_data|rust-analyzer
Ip|IpPacket|rust-analyzer
ip|ip_packet|rust-analyzer
da|data|rust-analyzer
Ip|IpPacket|buffer
regist|register_handler|rust-analyzer
PI|PI|rust-analyzer
Dere|Deref|rust-analyzer
Mul|Mul|rust-analyzer
|edges|rust-analyzer
Error|Error|rust-analyzer
thread|thread|rust-analyzer
from|from_millis|rust-analyzer
Duration|Duration|rust-analyzer
sle|sleep|rust-analyzer
ErrorK|ErrorKind|rust-analyzer
new|new|rust-analyzer
Dur|Duration|rust-analyzer
s|SeqCst|rust-analyzer
Ordering|Ordering|rust-analyzer
Ordr|Ordering::SeqCst|rust-analyzer
Ord|Ordering|rust-analyzer
Order|Ordering|rust-analyzer
Atom|AtomicBool|rust-analyzer
pre|prelude|rust-analyzer
int|interfaces|rust-analyzer
get_|get_interface_map|rust-analyzer
link|link_layer|rust-analyzer
gd|get_edge|buffer
.|..Default::default()|rust-analyzer
collect|collect|rust-analyzer
hcv|h_c_v|rust-analyzer
db|dbg|around